0 0 0 0 0 0 0 0 0 0 0 0 0 0 0 0 0
0 0 0 0 4 4 4 4 4 4 4 0 0 0 0 0 0
0 0 0 0 4 4 4 4 4 4 4 0 0 0 0 0 0
0 1 1 1 1 0 0 0 0 0 1 1 1 0 0 0 0
0 1 1 1 0 0 0 0 0 0 0 1 1 0 0 0 0
0 1 1 1 0 0 0 0 0 0 0 1 1 0 0 0 0
0 1 S 1 0 0 1 1 1 1 4 4 4 4 4 0 0
0 1 1 1 0 0 1 1 1 1 4 4 4 4 4 0 0
0 0 0 0 0 0 1 E 1 0 0 4 4 1 4 0 0
0 0 0 0 0 0 1 1 1 0 0 4 4 4 4 0 0
0 0 0 0 0 0 0 0 0 0 0 0 0 0 0 0 0
0 0 0 0 0 0 0 0 0 0 0 0 0 0 0 0 0