0 0 0 0 0 0 0 0 0 0 0 0 0 0 0 0 0
0 0 0 0 0 0 0 0 0 0 0 0 1 1 1 1 0
0 0 1 1 1 1 5 5 1 2 1 1 1 1 S 1 0
0 0 1 1 1 1 0 0 0 0 0 0 0 1 1 1 0
0 0 1 1 2 1 0 0 0 0 0 0 0 0 0 0 0
0 0 1 1 1 1 0 0 0 0 0 0 0 0 0 0 0
0 0 0 0 1 1 1 2 1 5 5 1 1 1 0 0 0
0 0 0 0 0 0 0 0 0 0 0 1 1 1 1 2 0
0 1 1 1 0 0 0 0 0 0 0 1 1 1 1 1 0
0 1 E 1 1 1 5 5 1 1 1 1 1 1 0 0 0
0 1 1 1 1 0 0 0 0 0 0 0 0 0 0 0 0
0 0 0 0 0 0 0 0 0 0 0 0 0 0 0 0 0